{
  "Blocks": [
    { "x": 8, "y": 8 },
    { "x": 8, "y": 9 },
    { "x": 7, "y": 8 },
    { "x": 2, "y": 4 },
    { "x": 3, "y": 6 },
    { "x": 4, "y": 3 },
    { "x": 5, "y": 8 },
    { "x": 6, "y": 10 }  
  ]
}